NO ./textures/gray_stone_wall.xpm
SO ./textures/red_brick_wall.xpm
WE ./textures/brown_brick_wall.xpm
EA ./textures/rough_red_brick_wall.xpm
DC ./textures/door.xpm
DO ./textures/door_open.xpm

F 220,100,0
C 225,30,0

11111111111111111111111111111
11110111111111011101010010001
11110111111111011101010010001
11110111111111011101010010001111
111111111011000001110000000000001
100000000011000001110111101011111
11110111111111011100000010D11
11110111111111011101010010101
11000000110101011100000010001
10000000000000001100000010001
10000000000000001101010010001
11000001110101011111011110N0111
11110111 1110101 101111010001
11111111 1111111 111111111111