NO ./textures/gray_stone_wall.xpm
SO ./textures/red_brick_wall.xpm
WE ./textures/brown_brick_wall.xpm
EA ./textures/rough_red_brick_wall.xpm
DC ./textures/door.xpm
DO ./textures/door_open.xpm
D2 ./textures/door2.xpm
D3 ./textures/door3.xpm

F 220,100,0
C 225,30,0

11111111111111111111111111111
11010101010101010101010101011
100D0D0D0D0D0D0D0D0D0D0D0D001
11010101010101010101010101011
11D1D1D1D1D1D1D1D1D1D1D1D1D111
100D0D0D0D0D0D0D0D0D0D0D0D001
11010101010101010101010101011
11D1D1D1D1D1D1D1D1D1D1D1D1D111
10000000000000N00000000000001
10000000000000000000000000001
10000000000000000000000000001
10000000000000000000000000001
11111111111111111111111111111